10
10
2222222222
2000000002
2000000002
2000400002
2000000002
2000000002
2000000002
2000700002
2000000002
2222222222
#