10
10
2222222222
2000400002
2000000002
2000070002
2000000002
2000070702
2000000002
2000000002
2000700002
2222222222
#
第一行 列数
第二行 行数