10
10
2222222222
2000040002
2000000002
2000000002
2000000002
2000000002
2000000002
2000000002
2000700002
2222222222
#