10
10
2222222222
2000400002
2010000002
2111111112
2000010002
2000020002
2000010002
2000000002
2000700002
2222222222
#
第一行 列数
第二行 行数