20
20
22222222222222222222
24000000020000000042
20100001000000000002
21110111100000100002
20000100011110000002
20011200020000100002
20000106666000100002
21100006666000000002
20000000060000100002
23333333333333333332
20000000000000000002
20001000020000600022
20101010101010101002
21110111120202120202
20000100660000000002
20011200660000100002
20000100010000100002
21100000202000000002
20000000272000100002
22222222222222222222
#
第一行 列数
第二行 行数